EA ./Includes/default.xpm
NO ./Includes/default.xpm
SO ./Includes/default.xpm
WE ./Includes/default.xpm
F 220,100,0
C 225,30,0

                                   111111111111111111111111111111111111    
                   111111111111111110000000000000000000100000000011111111    
                  111111111110000000000E0000000100000000000000000000000001  
                     1111111111111100000000000000000000000111111111111111      
                              11111111111111111111111111111

   



                         
