
EA ./Includes/default.xpm
											       
NO ./Includes/default.xpm

SO ./Includes/default.xpm

		WE                             ./Includes/default.xpm                         

F 255,255,255		

C 0,0,0


111111111111111111111111111111111111111111111111
100000000000000000000000000000000000000000000001
100000000000000000000000000000000000000000000001
111000000000000000000010000000S00000000000000001
  1000000000000000000000000000000000000000000001
  1111111111111111111111111111111111111111111111





                          
                        
