        
        F                 0,255 , 255				   
                                  SO Makefile

NO     Makefile

                EA  Makefile

                C 120     ,           0,      1                          
                WE                  Makefile			


                                   111111111111111111111111111111111111    
                   111111111111111110000000000000000000100000000011111111    
                  111111111110000000000S0000000100000000000000000000000001  
                     1111111111111100000000000000000000000111111111111111      
                              11111111111111111111111111111                   

