
                          
                        
NO test.xpm

SO test.xpm

WE test.xpm

EA test.xpm 

11111111
10000001
1111W111
11111111