F 1, 1, 5

C 0, 0, 5

NO Makefile   
SO  Makefile
EA  Makefile
WE  Makefile
 

 111111111111111111111111111111111111
1110000000000000000000000000000000001
100000000000000W000000000000000000001
1111111111111111111111111111111111111

