
EA ./Includes/default.xpm
											       
NO ./Includes/default.xpm

SO ./Includes/default.xpm

		WE                             ./Includes/default.xpm                         

F 100,1,0		

C 50,100,0


111111111111111111111111111111111111111111111111
100000000000000000000000000000000000000000000001
1000000000000000000000N0000000000000000000000001
111111111111111111111111111111111111111111111111





                         
