
EA ./Includes/default.xpm
											       
NO ./Includes/default.xpm

SO ./Includes/default.xpm

		WE                             ./Includes/default.xpm                         

F 255,255,255		

C 0,0,0


111111111111111111111111111111111111111111111111
100000000000000101000000000000000000000000000001
100000000000000001001000000000000000000000000001
100E00000000000000000000100000000000000000000001
100000000000000010001010000000000000000000000001
111111111111111111111111111111111111111111111111





                          
                        
