NO ./path

SO ./path


     F 0, 255 ,255

C 255, 255, 0

EA ./path


WE ./path


                                   11111111111111111111111111111111111
                   111111111111111110000000000000000000100    00000001111111111
                  11111111111        0000000000100000000000000  W   00000000001
                     111111111111111   00000000000000000000     1111111111111
                                    11111111111111111111111111111

