                F                 0,255 , 255

                                  SO ./path




                EA./path

                C 120,0,1
                WE ./path


                                   11111111111111111111111111111111111
                   11111111111111111000000000000000000010000000001111111111
                  11111111111000000000000000000100000000000000W00000000001
                     11111111111111100000000000000000000000111111111111111
                              11111111111111111111111111111

