
EA ./Includes/default.xpm
											       
NO ./Includes/default.xpm

SO ./Includes/default.xpm

		WE                             ./Includes/default.xpm                         

F 255,255,255		

C 0,0,0


11111111111111
10000000000001
10000000N00001
10000000000001
11111111111111





                          
                        
