NO	sprites/surprise.xpm
SO	sprites/surprise.xpm
WE	sprites/surprise.xpm
EA	sprites/surprise.xpm

F 255,255,255		

C 0,0,0


11111
10001
10001
10001
10001
10001
10001
10001
10001
10001
10001111111111111111111
10000000000000000000001
10N00000000000000000001
10000000000000000000001
11111111111111111111111




                          
                        
