
	NO		     ./Includes/default.xpm
F 2,2, 2 
SO 			./Includes/default.xpm
C 1,	1, 1

EA ./Includes/default.xpm
			WE	./Includes/default.xpm     
	  1111111111111111
          1110000W000111111
          1100000001111
          11111111111
   



                         
