
EA ./Includes/default.xpm
											       
NO ./Includes/default.xpm

SO ./Includes/default.xpm

		WE                             ./Includes/default.xpm                         

F 255,255,255		

C 0,0,0


11111111111111
10000000000001
10000000010001
10000000011111
11100000000001
10000000000001
10000000001111
10000000001001
10110000000001
10010000001001
100000N0000001
11111111111111





                          
                        
