
F 2,2,2


NO ./Includes/default.xpm

SO ./Includes/default.xpm
C 1,	1, 1
EA ./Includes/default.xpm

WE	./Includes/default.xpm

          111111111111111
          1110000W000111111
          1100000001111
          11111111111
