NO	sprites/pipe_wall.xpm
SO	sprites/pipe_wall.xpm
WE	sprites/pipe_wall.xpm
EA	sprites/pipe_wall.xpm

C	125, 219, 227
F	79, 91, 92

DC	sprites/tac.xpm
DO	sprites/blank.xpm

CR	sprites/crosshair_HL2.xpm
#the map itself


        11111111111111111111111
      111000D0000000D0000000001
    111000011100000011111111001
  1110000111000000111000W111001
1110000111 11100000000011100001
10000111  111000000011100000111 
10011111111111000111000001111
100000001110000111000000001
100000011100011111111111001
10000000D00000000000000D001
111111111111111111111111111

