NO  Includes/default.xpm
SO  Includes/default.xpm
EA  Includes/default.xpm
WE  Includes/default.xpm

C  50,50,50
F  200,25,25


11111111111111
10000000000001
10000000000111
100000000001S1
10000000000111
11111111111111