NO	sprites/hq_wood.xpm
SO	sprites/hq_leaves.xpm
EA	sprites/hq_ice.xpm
WE	sprites/hq_honeycomb.xpm

C	125, 219, 227
F	79, 91, 92

11111111111111111111111111111111111111111
10001000001010000010000000101000000000001
11101110111010101110111110101111101010111
10100000101000101010001010100000001010001
10111110101110111010111011111111101110111
10000010000000100010100000001010000010001
11101110101111101010111011111011101111101
10100000100010001000101000000010001000001
10101111101110111110101011111111111011101
10001010000000100010000000000000000010001
11101011111110101011111110111011101110111
10100000001000001000100000001010001010001
10111011111011101110111011111111101011101
10001000100010000010100010001000100010001
10111111111010111111111011101110111111111
10100010000010100000100010101000000010001
10101110111010101110111110101111101011101
10101000101010101000001000001000101010001
10101110101011111011111111101011101111101
10001000001010001010000000100000000000101
11101111101111101N11111110111111101110101
10000010000010000000001010101010000010001
11111011101110111111111010101010111110111
10101000100010100010001000001000100000101
10101110101010111010111110101111101010101
10001010001000001010100010100000001010001
10101011111011101010111010111110101110111
10101000100010000000101000000010101010001
11101110101110101110101110101111111010111
10100010001000101000000000101000000010101
10101010101111101111101110111011111110101
10001000100010001000001010101000000010001
11101111111111111011111010101011111111111
10101000000000000010101010100010001000101
10111011101110111010101011111011101011101
10000010000010001000100010000000100000001
10101110111111111110111011101011111011101
10100010100000101000100010001010100010001
11101011111110101011101011101110101110111
10001000001000000000001000000000001000001
11111111111111111111111111111111111111111
