NO	sprites/basic.xpm
SO	sprites/basic.xpm
WE	sprites/basic.xpm
EA	sprites/basic.xpm

F	#027A90
C	#3F5DF8


               1111111
               1000001
               1000001
               1000001
               1000001
               1000001
               1000001
               1000001
               1000001
               1000001
               1000001
               1000001
               1000001
               1000001
               1000001
111111111111111100000111111111111111
100000000000000000000000000000000001
100000000000000000000000000000000001
100000000000000000N00000000000000001
100000000000000000000000000000000001
100000000000000000000000000000000001
111111111111111100000111111111111111
               1000001
               1000001
               1000001
               1000001
               1000001
               1000001
               1000001
               1000001
               1000001
               1000001
               1000001
               1000001
               1000001
               1000001
               1111111
             
