NO	sprites/basic.xpm
SO	sprites/basic.xpm
WE	sprites/basic.xpm
EA	sprites/basic.xpm

F	2, 122, 144
C	63, 93, 248


               1111111
               1000001
               1000001
               1000001
               1000001
               1000001
               1000001
               1000001
               1000001
               1000001
               1000001
               1000001
               1000001
               1000001
               1000001
111111111111111100000111111111111111
100000000000000000000000000000000001
100000000000000000000000000000000001
100000000000000000000000000000000001
100000000000000000000000000000000001
100000000000000000000000000000000001
111111111111111100000111111111111111
               1000001
               1000001
               1000001
               1000001
               1000001
               1000001
               1000001
               1000001
               1000001
               1000001
               1000001
               1000001
               1000001
               100N001
               1111111
             
