NO	sprites/default.xpm
SO	sprites/default.xpm
WE	sprites/default.xpm
EA	sprites/default.xpm

F	2, 122, 144
C    125, 219, 227


               1111111
               1000001
               1000001
               1000001
               1000001
               1000001
               1000001
               1000001
               1000001
               1000001
               1000001
               1000001
               1000001
               1000001
               1000001
111111111111111100000111111111111111
100000000000000000000000000000000001
100000000000000000000000000000000001
100000000000000000000000000000000001
100000000000000000000000000000000001
100000000000000000000000000000000001
111111111111111100000111111111111111
               1000001
               1000001
               1000001
               1000001
               1000001
               1000001
               1000001
               1000001
               1000001
               1000001
               1000001
               1000001
               100N001
               1000001
               1111111
