F	79, 91, 92
C	125, 219, 227


SO	./sprites/Hstrips_black_white_64x64.xpm
NO	./sprites/Vstrips_black_white_64x64.xpm
WE	./sprites/Hstrips_black_white_64x64.xpm
EA	./sprites/Vstrips_black_white_64x64.xpm


111111111111111111111
1E0010100010100010001
111010101110111010101
100010100000000000101
101010101111101111111
101000100010101000101
101110101010111110101
101000001010001000001
101011111010111011111
101010000000101000101
111110101111101010101
100000100010000010001
111111111010111011111
101000100000100000101
101011101111101111101
100000000010100010001
111110111010111011101
101010001010000000001
101010101110101111101
100000100010100010001
111111111111111111111
