SO	./Includes/default.xpm
NO	./sprites/pipe_wall.xpm
WE	./sprites/gear_wall.xpm
EA	./sprites/pipe_wall.xpm

F	148,83,50
C	51,255,255

111111111111111111111111111111111111111111
100001100010000111000000101000001110000001
100000000110011000001100110011001100000001
110011100000000001001100000100000000111001
100000111110001111111001100110011100111111
100100000010000000100000000000000000001111
100100000001001100011111111111111111111111
100100110001000100011
100111111000111111011
100110000000100011011
11111110011110E010001
100000000010000000001
111011111110111011111
100000100000000000001111111111111111111111
100011111111101111001101011101111101111011
100000000010100010001100000000011111110001
110110111111100111111100000000011110010001
100110010000000000001111110011011110010001
100110010000000000001100110000110001110111
100001100011000010001100000100000000000011
111111111111111111111111111111111111111111
