NO	sprites/Wall_Vent.xpm
SO	sprites/Wall_Steel_bulkhead.xpm
EA	sprites/Wall_Weathered_brick.xpm
WE  sprites/Wood_slats.xpm
F 79, 1, 92
C 125, 219, 227

11111111111111111111111111111111111111111111111111111111111111111111111
10000010010000000000000000010010000000001000001001000000000000000000001
10011110010011111111111111110010100000101001001001001111111001111001111
10010000000000010000000000000010000000001001000001001000000001000000001
10010011111110011111110011111110000000001111111001001111111111001001111
1000000001001000000000000001001001S100000000000001000001000001001000001
10011111110011110011111110010010000000001001001111001111111001001111001
10010000010000000000010010000010000000001001000000000001000001001000001
10010011111110011110010011110010100000101001001111001111001001111001111
10010010010000010010000010000010000000001001001000000001001000000000001
10010010011110010011111111111111011011011001001111001111001001001001111
10000000010010000000000000000010000000001001001000001000001001001000001
10011110010011110011110011111110100000101111001111111111001111111001001
10000010010000010010000000000010000000001000001000000000001000001001001
10010011110011111111111111111110000000001111001111111111001001111111001
10010010010010010000010000010000000000001000001000001000001000001000001
10011110010010010010011110010010000000001111001111001001111001001001111
10000010010000000010010000000010000000001000001001000001001001001000001
10011110010011111111110011110010100000101111111001001111001001111111001
10000000000000000000000010000010000000001000000000000001000000000000001
11111111111111111111111111111111111111111111111111111111111111111111111
