NO ./Includes/default.xpm
SO ./Includes/default.xpm
WE ./Includes/default.xpm
EA ./Includes/default.xpm

C 26,161,199
F 107,75,85


111     111
10011111001
10000000001
11110001111
   10001
   10N01
   10001
11110001111
10000000001
10011111001
1111   1111
