NO ./sprites/basic.xpm
SO ./sprites/basic.xpm
WE ./sprites/basic.xpm
EA ./sprites/basic.xpm

C 26,161,199
F 107,75,85

11111       11111
10001       10001
10001       10001
10001       10001
10001       10001
10001       10001
10001       10001
10001       10001
10001       10001
10001       10001
10001       10001
10001       10001
10001111111110001
10000000000000001
10000000000000001
10000000N00000001
11111111111111111
