NO ./sprites/basic.xpm
SO ./sprites/basic.xpm
WE ./sprites/basic.xpm
EA ./sprites/basic.xpm

C 26,161,199
F 107,75,85


111111111111111111
100000000S00000001
100000000000000001
100000000000000001
100011111111110001
10001        10001
10001        10001
10001        10001
10001        10001
10001        10001
10001        10001
10001        10001
10001        10001
10001        10001
10001        10001
10001        10001
11111        11111
