NO ./sprites/basic.xpm
SO ./sprites/basic.xpm
WE ./sprites/basic.xpm
EA ./sprites/basic.xpm

C 26,161,199
F 107,75,85


11111111111
10000100001
10000100001
10000100001
10000000001
10000N00111
10000000001
11110000001
10000001111
10000000001
11111111111
