NO ./sprites/basic.xpm
SO ./sprites/basic.xpm
WE ./sprites/basic.xpm
EA ./sprites/basic.xpm

C 26,161,199
F 107,75,85


       11111
       10001
       10001
       10001
    11110001111
    10000000001
    10000000001
1111100000000011111
1000000000000000001
100000000N000000001
1000000000000000001
1111100000000011111
    10000000001
    10000000001
    11110001111
       10001
       10001
       10001
       11111
