NO default.xpm
SO default.xpm
WE default.xpm
EA default.xpm

C 26,161,199
F 107,75,85



1111111111111111111111111111
1000000000000000000000000001
1000000000000N00000000000001
1000000000000000000000000001
1000001111111111111111000001
1000001              1000001
1000001              1000001
1000001              1000001
1000001              1000001
1000001              1000001
1000001111111101111111000001
1000000000000000000000000001
1000000000000000000000000001
1000000000000000000000000001
1111111111111111111111111111
